0000220000222
0101012101010
0020002000200
0101010101010
2000200000000
0101010121010
0022000022222
0101010101010
0000002020000
0101210101010
0022200200000