0000000000222
0101212101010
0000222000200
0101010101010
2000200000000
0101011111010
0022000020001
0121010100010
0010000021100
0101110101010
0002000200000